----------------------------------------
--GG---GG---GG-----GG------GG---GG------
---------------GGGG---------------------
--GGG-----------------GGG---------------
@-----GGGG----------------GGGG--------#-
GGGG----GGGG--GGGGGGGGGG----GGGG--GGGGGG