20
6
--------------------
--GG---GG---GG------
--------------------
--GGG---------------
@-----GGGG--------#-
GGGG----GGGG--GGGGGG